wWWwWWWWWWWWWWWWWWWWWWWWWWWWWWWw
w3pw1R11111111111111111111111e1w
w33w1E11111111111111111111111L1w
w33WWR1WWWWWWwWW11wWWWWWWWWWWWWw
w111111s111s5w5E55w444444444444w
w555555555555w5DD5w44w4444wwww4w
wWWwWWWWWWWWWw5555w4Ew444444Ew4w
w33w333333333w5225w4DwR44444Dw4w
w3SWWWWw3E333w5225w44w4444444w4w
wDD3333w3D333w5225w44wU44444Lw4w
w3333S3w33333w5225w44WWWW4444W4w
w33WWWWW33333w5225w444444444444w
w333333333333w5225w44wwww444444w
w333333333333w5225w44w4e44444w4w
w33wWWWW3U333w5225w44w4D44444w4w
w33w3R33333D3w5225w44w4444444w4w
w33w333333333w5225w44w444444ew4w
w33w333333333w5225w44W4444WWWW4w
w33w333333333w5225w4444U4D444L4w
w33w3e3333333w5225w444444444444w
w33W3U33333L3W5225W444444R444U4w
w3U3S33333333555e54444444444444w
wU33L3333333355UU544R44444444U4w
wwwwwwwwwwwwwwwwwwwwwwwwwwwwwwww
