wWWWWWWWWWWWwWWWWwWWWWWWWWWWWWWw
w11111111e11w11E1w11e1111111111w
w1R111111L11w11D1w11R11111111L1w
w1DwWWWWWW11W1111W11WWWWWWWWwD1w
w11w1R111D1111111111D11111L1w11w
w11w111111111111111111111111w11w
w11w111111111111111111111111w11w
w11w11111111w1111w1111111111w11w
w11w11111111w11U1w1111111111w11w
w11w11111111w1WWWw1111111111w11w
w11w11111111w1111w1111111111w11w
w1eW1E111111w1111w11111111E1We1w
w1U11U111L11w1111w11R11111U11U1w
w11111111111w1111w1111111111111w
wWWWWWWWWWWWW1111WWWWWWWWWWWWWWw
w33333333333e3333e3333333333333w
wR3333333333L3333R333333333333Lw
w222WWWWWwWWWw33wWWWwWWWWWWW555w
w2D2222L2w4D4w33w4D4w5R5555555Dw
w22222222w444w33w444w5555555555w
w22222222W444w33w444W5555555555w
w222222E244S4w33w4S445E55555555w
w2R2222U244U4w3pw4U445U5555555Lw
wwwwwwwwwwwwwwwwwwwwwwwwwwwwwwww
