wWWWWWWWWWWWWWWWWWwWWWWWWWWWWWWw
w2e252525252525252w444444e4w1p1w
w2R25252525252L252w4D4444D4w121w
w252wwwwwwwwww5252w44444444w151w
w252w66666666w5252w44444444w121w
w252WWWWWWWWWW5252w44444444w151w
w25252525252525252w44444444w121w
w2525252525252S252w44444444W151w
w2R25252525252L252w444444444121w
w252wwwwwwwwww5252w444444444151w
w252w66666666w5252w4E444444w121w
w252WWWWWWWWWW5252w4U4444U4w151w
w25252525252525w3ewWWWWWWWWw121w
w2R2525D5D525L5w3Dw3E333333w151w
w25252525252525w33w3R33333Lw121w
w252www252www25w33WWWWWWW33W151w
w252w6w252w6w25w3D33333333L3121w
w252w6w252w6w25w3R33333333U3151w
w252w6w252w6w25WWWwWWW33WWWw121w
w252WWW252WWW25252w3R33333Dw151w
w25252525252525252w3e333333w121w
w2525S52525E525252w3U33333Lw151w
w2U25L5L5R5R5U5252w33333333w111w
wwwwwwwwwwwwwwwwwwwwwwwwwwwwwwww
