wWWWWWWWWwWWWWWWWWwWWWWWWWWwWWWw
w44444444w44444444w44444444w1D1w
w44444444w44444444w44444444w111w
w44444444w44444444w44444444w111w
w4E444444w444444E4w4E444444w111w
w4R44444LwR44444L4w4R44444Lw1e1w
w44444444w44444444w44444444w1U1w
wWWW44WWWWWWW44WWWWWWW44WWWWWW1w
w333333333333333333333333333555w
w111111111111111111111111111555w
w333333333333333333333333333555w
wwWW11WWwwwWW11WWwwwWW11WWww555w
ws122221sws111111sws111111sw555w
w122DD221w1D11111Lw1R11111Dw555w
w1222S221w11133311w1E122211w555w
w12222221w1e133311w1U122211W555w
w12222221w1D133311w111222111555w
w12222221w11133311w111222111555w
w12222221w11133311w11122211w555w
w12222221w11133311w11122211w555w
w122S2221w11133311w11122211w555w
w122UU221w1111111ew1111111Ew555w
w11222211w1R11111Uw1U11111Lw5p5w
wwwwwwwwwwwwwwwwwwwwwwwwwwwwwwww
