wWWWWWWWWWWWWWWWWWWWWWWWWWWWWWWw
w333333311111111111111113333333w
w3333333R11111111111111D3333333w
w331111111111111111111111111133w
w331e1111111111111111111111e133w
w331111111111111111111111111133w
w33WWwW11111111e111111111WwWW33w
w3333w44111111111111111144w3333w
w3333W44111111111111111144W3333w
w333334411111111111111114433333w
w333334411111111111111114433333w
w3333w44U111111L1111111L44w3333w
w3333w44444444444444444444w3333w
w3333WWWWWWWWWWWWWWWWWWWWWW3333w
w33331D111111111111111111L13333w
w33331E111111111111111111e13333w
w333311111111111111111111113333w
w33331R111111111111111111U13333w
w33WWWWWWWWWw222222wWWWWWWWWW33w
w3311111s111w222222ws1111111133w
w33111111111w222222w11111111133w
w3311p111111W222222W11111111133w
w331111111112222222211111111133w
WWWWWWWWWWWWWWWWWWWWWWWWWWWWWWWW
