wWWWWWWWWWWWWwWWWwWWWWWWWWWwWWWw
w3D33L3333D33w2p2w444444444w111w
w333333333333w525w444444444W111w
w333333333333w525w4R44444D44111w
w333333w33333w525w4444444444111w
w3333e3w33E33w525w4S4444444w111w
w3R33U3w33U33w525w4U44444L4w111w
w333WWWWWWWWWW525WWWWWWWWWWW111w
w111s11111111s525s111111111s111w
w55555555555e5525e5555555555555w
wR5555555555L5525R555555555555Lw
wWWWWW1111WWWw525wWWW333WWWWWWWw
w111111111111w525w3333333333333w
w1D11111111L1w525w3e33333333333w
w111111111111w525w3R3333333333Lw
w111wwwwww111w525w333WWWWWWWWWWw
w111w6666w111w525w3333333333333w
w333w6666w333w525w1R111111111D1w
w3e3w6666w3E3w525w1111111111111w
w3D3WWWWWW3U3w525w11111111111E1w
w333333333333w525w1U111111111L1w
w3R33333333U3w525w1111111111111w
w333333333333w525w1111111111111w
WWWWWWWWWWWWWWWWWWWWWWWWWWWWWWWW
