wWWWWWWwWWWWWWWWWWWWWWWWWWWWWWWw
w3R333Dw11s111111111111111111D1w
w333333wD11L1111111111111111111w
w333333W11111wWWWWWW11111111111w
w3E3333311111w111R1D11111111111w
w3U333L311111w11111111111111111w
wWWWWWWW11111w111111wwwwwww1111w
wss2222222222w111111wwwwwww1111w
w1122222222e2w111E11wwwwwww1111w
w1122222R22U2w111U1LWWWWWWW1111w
w55wWWWWWWWWWw11111111111111111w
w55w3333D3333w11111111111111111w
w55w3D333333Lw111R1D11111111111w
w55W333w33333w11111111111111111w
w552333w33333w222222wwwwwww2222w
w552333w33333w222222wwwwwww2222w
w552w44W44444w555555wwwwwww5555w
w552w44444444w555555WWWWWWW5555w
w552w44444444w33333333333333333w
w333w44444444w333e3333333333333w
w3p3w4444444ew333U3L33333333333w
w333wR44E444Uw333333333333333e3w
w333w444U4444w333333333333333U3w
WWWWWWWWWWWWWWWWWWWWWWWWWWWWWWWW
