wWWWWWWWWWWWWwWWWWWWWWWWWWWWWWWw
w5D555555555Lw22E22222222222222w
w5555555555555e2R2222222222222Dw
w22222222222EwD5wWWWWWWWWWWWw22w
w2R222222222Uw55w11111e11111w22w
w555555555555w555E1111R1111Dw22w
w555555555555w55wDDww111ww11w22w
w111111WWWWWWW55w11ww111ww11w22w
w111111111111155W11ww111ww11W22w
w555555555555555111ww111ww11122w
w555555555555555111ww111ww11122w
w111111111111155w11ww111ww11w22w
wWWWWWWW44444w55w11ww111ww11w22w
w4R444444444Dw55w11ww111ww11w22w
w4S4444444444w55w11ww111ww11w22w
w4U444444444Lw55w11WW111WW11w22w
w444444444444w55w11111111111w22w
w444444444444w55w1E111U1111Lw22w
w444444444444w55wUU111111111w22w
wWWWWWWWWWWWWW5eWWWWWWWWWWWWW2Uw
w11111s111111sUU111111111111s22w
w3p3333333333333333333333333333w
w333333333333333333333333333333w
wwwwwwwwwwwwwwwwwwwwwwwwwwwwwwww
